g g g g g g g g g g g g g g g g p p p p 
g g g g g g g g g g g g g g g g p g g g 
g g g g g g g g g g g g g g g g p g g g 
g g g g g g g g g g g g g g g g p g g g 
g g g g g g g g g g g g g g g g p g g g 
g p p p p p p p g g p p p p p p p g g g 
g p g g g g g p g g p g g g g g g g g g 
g p g g g g g p g g p g g g g g g g g g 
g p g g g g g p g g p g g g g g g g g g 
g p g g g g g p g g p g g g g g g g g g 
g p g g g g g p g g p g g g g g g g g g 
g p g g g g g p g g p g g g g g g g g g 
g p g g g g g p p p p g g g g g g g g g 
g p g g g g g g g g g g g g g g g g g g 
g p g g g g g g g g g g g g g g g g g g 
g p g g g g g g g g g g g g g g g g g g 
g p g g g g g g g g g g g g g g g g g g 
b b b g g g g g g g g g g g g g g g g g 
b b b g g g g g g g g g g g g g g g g g 
b b b g g g g g g g g g g g g g g g g g